########################################
#......................................#
#......................................#
#......................................#
#......................................#
#.....##########.......................#
#.....#........#.......................#
#.....#........#.......................#
#.....#................................#
#.....#................................#
#.....#........#.......................#
#.....##########.......................#
#......................................#
#......................................#
#......................................#
#..............#######################.#
#..............#.....................#.#
#..............#.....................#.#
#..............#.....................#.#
#..............#.....................#.#
#..............#.....................#.#
#..............#.....................#.#
#..............#####.......###########.#
#......................................#
#......................................#
#......................................#
#.........###..........###.............#
#.........###..........###.............#
#......................................#
########################################